NO textures/north.xpm
SO textures/south.xpm
WE textures/west.xpm
EA textures/east.xpm

F 40,40,40
C 120,160,200

111111111111
1E0000X00001
1011110111D1
100001010001
100X01010X01
100001X00001
111111111111
