NO textures/north.xpm
SO textures/south.xpm
EA textures/east.xpm
WE textures/west.xpm

F 0,200,0
C 0,0,250

1111111
1010001
1000N01
1000001
1111111
