WE ./textures/west.xpm
NO ./textures/north.xpm
SO ./textures/south.xpm
EA ./textures/east.xpm

C 255,0,0
F 0,255,0

11111
100N1
10001
10001
11111
