

NO ./textures/north.xpm



WE ./textures/west.xpm
SO ./textures/south.xpm


EA ./textures/east.xpm

C 255,0,10

F 0,255,15




  111
 100N1
1010001
100001
11111
